10 5
0 2 0 2 0 0 2 0 2 0 
0 3 0 1 3 3 1 0 3 0 
0 1 0 1 0 0 1 0 1 0  
0 3 0 1 3 3 1 0 3 0  
0 2 0 2 0 0 2 0 2 0   
[0.5, 2.5, 270]#[9.5, 2.5, 90]
5!2.5
